bbbbbbbbbbbbbbbbbbbbbbbbbbbbbbbbbbbbbbbbbbbbbbbbbbbbbbbbbbbbbbbb
Cc                                                             b
C                                   1                          b
C                           CCCCCCCCCCCCCCC                    b
C                           C             C                   sb
C                           C             C               <CCCCb
C                           C 2          CCCCC<         <Cc    b
C                  CCCCCCCCCCCCC          C  cCCCCCCCCCCc      b
C                                      CCCc                    b
CCCCC       CCCC                                               b
C                                CCC                           b
C     3              CCCC                                      b
CCCCCCCC   CCCC                   5                           4b
C          C      CCC            CCC      CCC    CCC<     CCCCCb
C        CCC       C              C        C        cCC<     #Cb
C                  C            CCCCC      C           cCCCCCCCb
C               CCCCCCC   FFF     C      CCCCC                Cb
bbbbbbbbbbbbbbbbbbbbbbbbbbbbbbbbbbbbbbbbbbbbbbbbbbbbbbbbbbbbbbbb