BBBBBBBBBBBBBBBBBBBBBBBBBBBBBBBBBBBBBBBBBBBBBBBBBBBBBBBBBBBBBBBB
B                                                              B
B    ~                                                         B
B   DDDD           DDDD                   DDDD        ~        B
B                                                    DDDD      B
B                                                              B
B          DDDD                  DDDD                          B
B                                               DDDD           B
B s               DDDD                                         B
B DDDD                                                         B
B                           DDDDDD                             B
B          DDDD                                        DDDD    B
B                     ~               DDDD                     B
B                    DDDD                                      B
B    DDDD                                         DDDD         B
B                            DDDD                              B
B                                                              B
BBBBBBBBBBBBBBBBBBBBBBBBBBBBBBBBBBBBBBBBBBBBBBBBBBBBBBBBBBBBBBBB